111111111111111111111111111
100000000000000000000000001
100001000000000000000000001
111101000010000000000000001
100001111111111111111110001
100001000000000000111110001
100111111110000000111110001
100000000010000000000000001
100f00000011111111111100001
100000N00011000000000000001
111111111111111111111111111