NO images/wall/w_n1.xpm
SO images/wall/w_e4.xpm
WE images/wall/w_w2.xpm
EA images/wall/w_s3.xpm

F 27,79,114
C 33,47,61

        1111111111111111111111111
        1000000000110000000000001
        1011000001110000000000001
        1001000000000000000000001
111111111011000001110000000000001
1000000111111111111111111101111111
11110111              10000011
11110111              11010011
110000011111111111111110010001
10000000000000001100000010001
10000000000000000001010011011
1100000111010101111101111000111
11110111 1110101 101111010E01
11111111 1111111 111111111111