NO images/wall/w_n1.xpm
SO images/wall/w_e4.xpm
WE images/wall/w_w2.xpm
EA images/wall/w_s3.xpm

F 27,79,114
C 33,47,61

         11111111111111             111111111
         11111100000001             1111000E1
         11100000001001             100000001
         11100000001001             111100001
         11100000001001             111100001
111111111111000000010011111111111111111000001111111111
100000000000000000000000000000000000000000000000000001
100000000000000000000000000000000000000000000000000001
10111111111111111111111000000000000000000000000000001
100000000000000000000000000000000000000000000000000001
100000000000000000000000000000000000000000000000000001
111111111111111111111111111111111111111111111111111111