NO wall3.xpm
SO wall3.xpm
WE wall3.xpm
EA wall3.xpm

F 105,105,105
C 105,105,105

        1111111111111111111111111
        1000000000110000000000001
        1011000001110000000000001
        1001000000000000000000001
111111111011000001110000000000001
1000000000110000011101111D1111111
11110111111111011100000010001
11110111111111011101010010001
11000000110101011100000010001
10000000000000001100000010001
10000000000000000001010011D11
1100000111010101111101111000111
11110111 1110101 101111010E01
11111111 1111111 111111111111