11111111111111111111111
10000000000010000000001
10000100000010000000001
11110000001010000000001
10000000001010000000001
10000000111110000000001
10000000000000000000001
10000000000000000000001
111111N0011110000000001
10000000000000000000001
11111111111111111111111